1111111111111111111111111111111111111111111111111111111111111111111111111111111111111111111111111111
1000000000000000000000000000000000000000000000000000000000000000000000000000000000000000000000000001
1000000000000000000000000000000000000000000000000000000000000000000000000000000000000000000000000001
1000001111100000000000011111000000000000001111100000000000000111110000000000000001111100000000000001
1000001111100000000000011111000000000000001111100000000000000111110000000000000001111100000000000001
1000001111100000000000011111000000000000001111100000000000000111110000000000000001111100000000000001
1000000000000011111000000000000011111000000000000001111100000000000000001111100000000000001111100001
1000000000000011111000000000000011111000000000000001111100000000000000001111100000000000001111100001
1000000000000011111000000000000011111000000000000001111100000000000000001111100000000000001111100001
1000001111100000000000011111000000000000001111100000000000000111110000000000000001111100000000000001
1000001111100000000000011111000000000000001111100000000000000111110000000000000001111100000000000001
1000001111100000000000011111000000000000001111100000000000000111110000000000000001111100000000000001
1000000000000011111000000000000000000000000000000000000000000000000000001111100000000000001111100001
1000000000000011111000000000000000000000000000000000000000000000000000001111100000000000001111100001
1000000000000011111000000000000000000000000000000000000000000000000000001111100000000000001111100001
1000001111100000000000000000000000000000000000000000000000000000000000000000000001111100000000000001
1000001111100000000000000000000000000000000000000000000000000000000000000000000001111100000000000001
1000001111100000000000000000000000000000000000000000000000000000000000000000000001111100000000000001
1000000000000011111000000000000000000000000000000000000000000000000000001111100000000000001111100001
1000000000000011111000000000000000000000000000000000000000000000000000001111100000000000001111100001
1000000000000011111000000000000000000000000000000000000000000000000000001111100000000000001111100001
1000001111100000000000000000000000000000000000000000000000000000000000000000000001111100000000000001
1000001111100000000000000000000000000000000000000000000000000000000000000000000001111100000000000001
1000001111100000000000000000000000000000000000000000000000000000000000000000000001111100000000000001
1000000000000000000000000000000000000000000000000000000000000000000000000000000000000000000000000001
1000000000000011111000000000000011111000000000000001111100000000000000001111100000000000001111100001
1000000000000011111000000000000011111000000000000001111100000000000000001111100000000000001111100001
1000000000000011111000000000000011111000000000000001111100000000000000001111100000000000001111100001
1000000000000000000000000000000000000000000000000000000000000000000000000000000000000000000000000001
1000001111100000000000011111000000000000001111100000000000000111110000000000000001111100000000000001
1000001111100000000000011111000000000000001111100000000000000111110000000000000001111100000000000001
1000001111100000000000011111000000000000001111100000000000000111110000000000000001111100000000000001
1000000000000000000000000000000000000000000000000000000000000000000000000000000000000000000000000001
1000000000000000000000000000000000000000000000000000000000000000000000000000000000000000000000000001
1000000000000011111000000000000011111000000000000001111100000000000000001111100000000000001111100001
1000000000000011111000000000000011111000000000000001111100000000000000001111100000000000001111100001
1000000000000011111000000000000011111000000000000001111100000000000000001111100000000000001111100001
1000000000000000000000000000000000000000000000000000000000000000000000000000000000000000000000000001
1000000000000000000000000000000000000000000000000000000000000000000000000000000000000000000000000001
1111111111111111111111111111111111111111111111111111111111111111111111111111111111111111111111111111