1111111111111111111111111111111111111111111111111111111111111111111111111111111111111111111111111111
1000000000000000000000000000000000000000000000000000000000000000000000000000000000000000000000000001
1000000000000000000000000000000000000000000000000000000000000000000000000000000000000000000000000001
1000000000000000000000000000000000000000000000000000000000000000000000000000000000000000000000000001
1000000000000000000000000000000000000000000000000000000000000000000000000000000000000000000000000001
1000000000000000000000000000000113110000000000000000000000000000000000000000000000000000000000000001
1000000000000000000000000000000332330000000000000000000000000000000000000000011311000000000000000001
1000000000000000000000000000000113110000000000000000000000000000000000000000033233000000000000000001
1000000000000000000000000000000000000000000000000000000000000000000000000000011311000000000000000001
1000000000000000000000000000000000000000000000000000000011311000000000000000000000000000000000000001
1000000000000000000000000000000000000000000000000000000033233000000000000000000000000000000000000001
1000000000000000000000000000000000000000000000000000000011311000000000000000000000000000000000000001
1000000000000000000000000000000000000000000000000000000000000000000000000000000000000000000000000001
1000000000000000000000000000000000000000000000000010000000000000000000000000000000000000000000000001
1000000000000000000000000000000000000000000000000121000000000000000000000000000000000000000000000001
1000000000011311000000000000000000000000000000001111100000000000000000000000000000000000000000000001
1000000000033233000000000000000000000000000000012111210000000000000000000000000000000000000000000001
1000000000011311000000000000000011311000000000111111111000000000113110000000000000000000000000000001
1000000000000000000000000000000033233000000001111121111100000000332330000000000000000000000000000001
1000000000000000000000000000000011311000000011211111112110000000113110000000000000000000000000000001
1000000000000000000000000000000000000000000111111333111111000000000000000000000000000000000000000001
1000000000000000000000000000000000000000000000003333300000000000000000000000000000000000000000000001
1000000000000000000000000000000000000000000000003333300000000000000000000000000000000000000000000001
1000000000000000000000000000000000000000000000003333300000000000000000000000000000000000000000000001
1000000000000000000000000000000000000000000000003333300000000000000000000000000000000000000000000001
1000000000000000000000000000000000000000000000000000000000000000000000000113110000000000000000000001
1000000000000000000000000000000000000000000000000000000000000000000000000332330000000000000000000001
1000000000000000000000000000000000000000000000000000000000000000000000000113110000000000000000000001
1000000000000000000001131100000000000000000000000000000000000000000000000000000000000000000000000001
1000000000000000000003323300000000000000000000000000000000000000000000000000000000000000000000000001
1000000000000000000001131100000000000000000000000000000000011311000000000000000000000000000000000001
1000000000000000000000000000000000000000000000000000000000033233000000000000000000000000000000000001
1000000000000000000000000000000000000000000000000000000000011311000000000000000000000000000000000001
1000000000000000000000000000000000000000000000000000000000000000000000000000000000000000000000000001
1000000000000000000000000000000000000000000000000000000000000000000000000000000000000000000000000001
1000000000000000000000000000000000000000000000000000000000000000000000000000000000000000000000000001
1000000000000000000000000000000000000000000000000000000000000000000000000000000000000000000000000001
1000000000000000000000000000000000000000000000000000000000000000000000000000000000000000000000000001
1000000000000000000000000000000000000000000000000000000000000000000000000000000000000000000000000001
1111111111111111111111111111111111111111111111111111111111111111111111111111111111111111111111111111