1111111111111111111111111111111111111111111111111111111111111111111111111111111111111111111111111111
1010001000100010001000100010001000100010001000100010001000010001000100010001000100010001000100010101
1000101010101010101010101000100000000000000000000000000000000000000000000000000000000000000000000101
1010101010101010101010000000000000000000000000000000000000000000000000000000000000000000000000000101
1010101010101010101010000000000000000000000000000000000000000000000000000000000000000000000000000101
1010101010101010101010000000000000000000000000000000000000000000000000000000000000000000000000000101
1010101010101010101010000000000000000000000000000000000000000000000000000000000000000000000000000101
1010101010101010101010000000000000000000000000000000000000000000000000000000000000000000000000000101
1010101010101010101010000000000000000000000000000000000000000000000000000000000000000000000000000101
1010101010101010101010000000000000000000000000000000000000000000000000000000000000000000000000000101
1010101010101010101010000000000000000000000000000000000000000000000000000000000000000000000000000101
1010101010101010101010000000000000000000000000000000000000000000000000000000000000000000000000000101
1010101010101010101010000000000000000000000000000000000000000000000000000000000000000000000000000101
1010101010101010101010000000000000000000000000000000000000000000000000000000000000000000000000000101
1010101010101010101010000000000000000000000000000000000000000000000000000000000000000000000000000101
1010101010101010101010000000000000000000000000000000000000000000000000000000000000000000000000000101
1010101010101010101010000000000000000000000000000000000000000000000000000000000000000000000000000101
1010101010101010101010000000000000000000000000000000000000000000000000000000000000000000000000000101
1010101010101010101010000000000000000000000000000000000000000000000000000000000000000000000000000101
1010101010101010101010000000000000000000000000000000000000000000000000000000000000000000000000000101
1010101010101010101010000000000000000000000000000000000000000000000000000000000000000000000000000101
1010101010101010101010000000000000000000000000000000000000000000000000000000000000000000000000000101
1010101010101010101010000000000000000000000000000000000000000000000000000000000000000000000000000101
1010101010101010101010000000000000000000000000000000000000000000000000000000000000000000000000000101
1010101010101010101010000000000000000000000000000000000000000000000000000000000000000000000000000101
1010101010101010101010000000000000000000000000000000000000000000000000000000000000000000000000000101
1010101010101010101010000000000000000000000000000000000000000000000000000000000000000000000000000101
1010101010101010101010000000000000000000000000000000000000000000000000000000000000000000000000000101
1010101010101010101010000000000000000000000000000000000000000000000000000000000000000000000000000101
1010101010101010101010000000000000000000000000000000000000000000000000000000000000000000000000000101
1010101010101010101010000000000000000000000000000000000000000000000000000000000000000000000000000101
1010101010101010101010000000000000000000000000000000000000000000000000000000000000000000000000000101
1010101010101010101010000000000000000000000000000000000000000000000000000000000000000000000000000101
1010101010101010101010000000000000000000000000000000000000000000000000000000000000000000000000000101
1010101010101010101010000000000000000000000000000000000000000000000000000000000000000000000000000101
1010101010101010101010000000000000000000000000000000000000000000000000000000000000000000000000000101
1010101010101010101010000000000000000000000000000000000000000000000000000000000000000000000000000101
1010101010101010101010000000010000000001010000000000001001000010000000000000000010000000000000000101
1000100010001000100010000000000000000000000000000000000000000000000000000000000000000000000000000001
1111111111111111111111111111111111111111111111111111111111111111111111111111111111111111111111111111
