1111111111111111111111111111111111111111111111111111111111111111111111111111111111111111111111111111
1000000000000000000000000000000000000000000000000000000000000000000000000000000000000000000000000001
1000200302030123010320301200000000000000000000000000000000000000000000000000000000000000000000000001
1002200000012320000000000000000000000000000000000000000000000000000000000000000000000000000000000001
1000000000000000000000000030000000000000000000000000000000000000000000000000000000000000000000000001
1000000333213210000323000020000000000000000000000000000000000000000000000000000000000000000000000001
1000000020000000201000000010000000000000000000000000000000000000000000000000000000000000000000000001
1012120001000000032000000000000000000000000000000000000000000000000000000000000000000000000000000001
1000003100000000302100000000000000000000000000000000000000000000000000000000000000000000000000000001
1000000300000000000023213000000000000000000000000000000000000000000000000000000000000000000000000001
1000001002332100000000300000000000000000000000000000000000000000000000000000000000000000000000000001
1000020000000000300000001201000000000000000000000000000000000000000000000000000000000000000000000001
1000000000220232000000000203000000000000000000000000000000000000000000000000000000000000000000000001
1030000000000000000003000010000000000000000000000000000000000000000000000000000000000000000000000001
1000000000000000000020000001000000000000000000000000000000000000000000000000000000000000000000000001
1000000010000000000010000000000000000000000000000000000000000000000000000000000000000000000000000001
1000000020000000000000000000000000000000000000000000000000000000000000000000000000000000000000000001
1000000030000000000000000000000000000000000000000000000000000000000000000000000000000000000000000001
1000000001000000003000000000000000000000000000000000000000000000000000000000000000000000000000000001
1000000000200000000000000000000000000000000000000000000000000000000000000000000000000000000000000001
1000000000000002000000000000000000000000000000000000000000000000000000000000000000000000000000000001
1000000000000310000000000000000000000000000000000000000000000000000000000000000000000000000000000001
1000000000000000000000000000000000000000000000000000000000000000000000000000000000000000000000000001
1000000000000000000000000000000000000000000000000000000000000000000000000000000000000000000000000001
1000000000000000000000000000000000000000000000000000000000000000000000000000000000000000000000000001
1000000000000000000000000000000000000000000000000000000000000000000000000000000000000000000000000001
1000000000000000000000000000000000000000000000000000000000000000000000000000000000000000000000000001
1000000000000000000000000000000000000000000000000000000000000000000000000000000000000000000000000001
1000000000000000000000000000000000000000000000000000000000000000000000000000000000000000000000000001
1000000000000000000000000000000000000000000000000000000000000000000000000000000000000000000000000001
1000000000000000000000000000000000000000000000000000000000000000000000000000000000000000000000000001
1000000000000000000000000000000000000000000000000000000000000000000000000000000000000000000000000001
1000000000000000000000000000000000000000000000000000000000000000000000000000000000000000000000000001
1000000000000000000000000000000000000000000000000000000000000000000000000000000000000000000000000001
1000000000000000000000000000000000000000000000000000000000000000000000000000000000000000000000000001
1000000000000000000000000000000000000000000000000000000000000000000000000000000000000000000000000001
1000000000000000000000000000000000000000000000000000000000000000000000000000000000000000000000000001
1000000000000000000000000000000000000000000000000000000000000000000000000000000000000000000000000001
1000000000000000000000000000000000000000000000000000000000000000000000000000000000000000000000000001
1111111111111111111111111111111111111111111111111111111111111111111111111111111111111111111111111111
