1111111111111111111111111111111111111111111111111111111111111111111111111111111111111111111111111111
1000000000000000000000000000000000000000000000000000000000000000000000000000000000000000000000000001
1000000000000000000000000000000000000000000000000000000000000000000000000000000000000000000000000001
1000000000000000000000000000000000000000000000000000000000000000000000000000000000000000000000000001
1000000000000000000000000000000000000000000000000000000000000000000000000000000000000000000000000001
1000000000000000000000000000000000000000000000000000000000000000000000000000000000000000000000000001
1000000000000000000000000000000000000000000000000000000000000000000000000000000000000000000000000001
1000000000000000000000000000000000000000000000000000000000000000000000000000000000000000000000000001
1000000000000000000000000000000000000000000000000000000000000000000000000000000000000000000000000001
1000000000000000000000000000000000000000000000000000000000000000000000000000000000000000000000000001
1000000000000000000000000000000000000000000000000000000000000000000000000000000000000000000000000001
1000000000000000000001111111121111111000000000000000000000000000000000000011111000000000000000000001
1000000000000000000001121111111111211000000000000000000000000000000000000011111000000000000000000001
1000000000000000000001111111111111111000000000000000000000000000000000000012111000000000000000000001
1000000000000000000000000000000000000000000000000000000000000000000000000011111000000000000000000001
1000000000000000000000000000000000000000000000000000000000000000000000000011111000000000000000000001
1000000000000000000000000000000000000000000000000000000000000000000000000011121000000000000000000001
1000000000000000000000000000000000000000333333333333333333330000000000000011111000000000000000000001
1000000000000000000000000000000000000000311111111221111111130000000000000000000000000000000000000001
1000000000000000000000000000000000000000311111111221111111130000000000000000000000000000000000000001
1000000000000000000000000000000000000000311111111221111111130000000000000000000000000000000000000001
1000000000000000000000000000000000000000322222222222222222230000000000000000000000000000000000000001
1000000000000000000001111100000000000000311111111221111111130000000000000000000000000000000000000001
1000000000000000000001211100000000000000311111111221111111130000000000000000000000000000000000000001
1000000000000000000001111100000000000000311111111221111111130000000000000000000000000000000000000001
1000000000000000000001111100000000000000333333333333333333330000000000000000000000000000000000000001
1000000000000000000001112100000000000000000000000000000000000000000000000000000000000000000000000001
1000000000000000000001111100000000000000000000000000000000000000000000000000000000000000000000000001
1000000000000000000001111100000000000000000000000000000000000001111111211111111000000000000000000001
1000000000000000000001211100000000000000000000000000000000000001121111111112111000000000000000000001
1000000000000000000001111100000000000000000000000000000000000001111111111111111000000000000000000001
1000000000000000000000000000000000000000000000000000000000000000000000000000000000000000000000000001
1000000000000000000000000000000000000000000000000000000000000000000000000000000000000000000000000001
1000000000000000000000000000000000000000000000000000000000000000000000000000000000000000000000000001
1000000000000000000000000000000000000000000000000000000000000000000000000000000000000000000000000001
1000000000000000000000000000000000000000000000000000000000000000000000000000000000000000000000000001
1000000000000000000000000000000000000000000000000000000000000000000000000000000000000000000000000001
1000000000000000000000000000000000000000000000000000000000000000000000000000000000000000000000000001
1111111111111111111111111111111111111111111111111111111111111111111111111111111111111111111111111111