1111111111111111111111111111111111111111111111111111111111111111111111111111111111111111111111111111
1000000000000000000000000000000000000000000000000000000000000000000000000000000000000000000000000001
1000000000000000000000000000000000000000000000000000000000000000000000000000000000000000000000000001
1000000000000000000000000000000000000000000000000000000000000000000000000000000000000000000000000001
1000000000000000000000000000000000000000000000000000000000000000000000000000000000000000000000000001
1000000000000000000000000000000000000000000000000000000000000000000000000000000000000000000000000001
1000000000003232323232323232323232323232323232323232323232323232323232323232323232323232000000000001
1000000000002000000000000000000000000000000000000000000000000000000000000000000000000000000000000001
1000000000003000000000000000000000000000000000000000000000000000000000000000000000000000000000000001
1000000000002000000000000000000000000000000000000000000000000000000000000000000000000000000000000001
1000000000003000000000000000000000000000000000000000000000000000000000000000000000000000000000000001
1000000000002000000000023232323232323232323232323232323232323232323232323000000000000003000000000001
1000000000003000000000000000000000000000000000000000000000000000000000002000000000000002000000000001
1000000000002000000000000000000000000000000000000000000000000000000000003000000000000003000000000001
1000000000003000000000000000000000000000000000000000000000000000000000002000000000000002000000000001
1000000000002000000000000000000000000000000000000000000000000000000000003000000000000003000000000001
1000000000003000000000030000000000232323232323232323232323232300000000002000000000000002000000000001
1000000000002000000000020000000000300000000000000000020000000000000000003000000000000003000000000001
1000000000003000000000030000000000200000000000000000030000000000000000002000000000000002000000000001
1000000000002000000000020000000000000000000000000000000000000000000000003000000000000003000000000001
1000000000003000000000030000000000000000002000000000000000000300000000002000000000000002000000000001
1000000000002000000000020000000000000000003000000000000000000200000000003000000000000003000000000001
1000000000003000000000030000000000232323232323232323232323232300000000002000000000000002000000000001
1000000000002000000000020000000000000000000000000000000000000000000000000000000000000003000000000001
1000000000003000000000030000000000000000000000000000000000000000000000000000000000000002000000000001
1000000000002000000000020000000000000000000000000000000000000000000000000000000000000003000000000001
1000000000003000000000030000000000000000000000000000000000000000000000000000000000000002000000000001
1000000000002000000000023232323232323232323232323232323232323232323232323000000000000003000000000001
1000000000000000000000000000000000000000000000000000000000000000000000000000000000000002000000000001
1000000000000000000000000000000000000000000000000000000000000000000000000000000000000003000000000001
1000000000000000000000000000000000000000000000000000000000000000000000000000000000000002000000000001
1000000000000000000000000000000000000000000000000000000000000000000000000000000000000003000000000001
1000000000003232323232323232323232323232323232323232323232323232323232323232323232323232000000000001
1000000000000000000000000000000000000000000000000000000000000000000000000000000000000000000000000001
1000000000000000000000000000000000000000000000000000000000000000000000000000000000000000000000000001
1000000000000000000000000000000000000000000000000000000000000000000000000000000000000000000000000001
1000000000000000000000000000000000000000000000000000000000000000000000000000000000000000000000000001
1000000000000000000000000000000000000000000000000000000000000000000000000000000000000000000000000001
1000000000000000000000000000000000000000000000000000000000000000000000000000000000000000000000000001
1111111111111111111111111111111111111111111111111111111111111111111111111111111111111111111111111111