1111111111111111111111111111111111111111111111111111111111111111111111111111111111111111111111111111
1000000000000000000000000000000000000000000000000000000000000000000000000000000000000000000000000001
1000000000000000000000000000000000000000000000000000000000000000000000000000000000000000000000000001
1000000000000000000000000000000000000000000000000111000000000000000000000000000000000000000000000001
1000000000000000000111100000000000000000000000000111000000000000000000000000000000000000000000000001
1000000000000000000111100000000000000000000000000111000000000000000000000111110000000000000000000001
1000000000000000000111100000000000000000000000000000000000000000000000000111110000000000000000000001
1000000000000000000000000000000000000000000000000000000000000000000000000111110000000000000000000001
1000000000000011111111111111100000000000000000000000000000000000000011111111111111100000000000000001
1000000000000011111111111111100000000000000000000000000000000000000011111111111111100000000000000001
1000000000000011111111111111100000000000000000000000000000000000000011111111111111100000000000000001
1000000000000000000000000000000000000001111000000000000000011110000000000111110000000000000000000001
1000000000000000000111100000000000000010000000000000000000000010000000000111110000000000000000000001
1000000000000000000111100000000000000010000000000000000000000010000000000111110000000000000000000001
1000000000000000000111100000000000000000000000000000000000000000000000000000000000000000000000000001
1000000000000000000000000000000000000000000000000000000000000000000000000000000000000000000000000001
1000000000000000000000000000000000000000000000000000000000000000000000000000000000000000000000000001
1000000001111111111111111111111111111110000000000000000000000001111111111111111111111111100000000001
1000000000000000000000000000000000000000000000000000000000000000000000000000000000000000000000000001
1000000000000000000000000000000000000000000000000000000000000000000000000000000000000000000000000001
1000000000000000000000000000000000000000000000000000000000000000000000000000000000000000000000000001
1000000000000000000110000000110000000001000000000000000000000010000000000000000000000000000000000001
1000000000000000000011000001100000000001000000000000000000000010000000000000000000000000000000000001
1000000000000000000001100011000000000001111000000000000000011110000000000000000000000000000000000001
1000000000000000000000110110000000000000000000000111000000000000000000000000000000000000000000000001
1000000000000000000000110110000000000000000000000111000000000000000000000000000000000000000000000001
1000000000000000000000110110000000000000000000000111000000000000000000000000000000000000000000000001
1000000000000000000001100011000000000000000000000111000000000000000000000000000000000000000000000001
1000000000000000000011000001100000000000000000000111000000000000000011111111111111100000000000000001
1000000000000000000110000000110000000000000000000111000000000000000000000000000000000000000000000001
1000000000000000001100000000011000000000000000000111000000000000000000000000000000000000000000000001
1000000000000000000000000000000000000000000000000111000000000000000000000000000000000000000000000001
1000000000000000000000000000000000000000000000000111000000000000000000000000000000000000000000000001
1000000000000000000000000000000000000000000000000111000000000000000000000000000000000000000000000001
1000000000000000000000000000000000000000000000000111000000000000000000000000000000000000000000000001
1000000000000000000000000000000000000000000000000111000000000000000000000000000000000000000000000001
1000000000000000000000000000000000000000000000000111000000000000000000000000000000000000000000000001
1000000000000000000000000000000000000000000000000000000000000000000000000000000000000000000000000001
1000000000000000000000000000000000000000000000000000000000000000000000000000000000000000000000000001
1111111111111111111111111111111111111111111111111111111111111111111111111111111111111111111111111111