1111111111111111111111111111111111111111111111111111111111111111111111111111111111111111111111111111
1000000000000000000000000000000000000000000000000000000000000000000000000000000000000000000000000001
1000000000000000000000000000000000000000000000000000000000000000000000000000000000000000000000000001
1000000000000000000000000000000000000000000000000000000000000000000000000000000000000000000000000001
1000000000000000020000000000002000000000000200000000000020000000000002000000000000200000000000000001
1000000000000000232000000000023200000000002320000000000232000000000023200000000002320000000000000001
1000000000000000020000000000002000000000000200000000000020000000000002000000000000200000000000000001
1000000000000000000000000000000000000000000000000000000000000000000000000000000000000000000000000001
1000000000000000000000000000000000000000000000000000000000000000000000000000000000000000000000000001
1000000000200000000000020000000000002000000000000200000000000020000000000002000000000000200000000001
1000000002320000000000232000000000023200000000002320000000000232000000000023200000000002320000000001
1000000000200000000000020000000000002000000000000200000000000020000000000002000000000000200000000001
1000000000000000000000000000000000000000000000000000000000000000000000000000000000000000000000000001
1000000000000000000000000000000000000000000000000000000000000000000000000000000000000000000000000001
1000000000000000000000000000000000000000000000000000000000000000000000000000000000000000000000000001
1000000000000000020000000000002000000000000200000000000020000000000002000000000000200000000000000001
1000000000000000232000000000023200000000002320000000000232000000000023200000000002320000000000000001
1000000000000000020000000000002000000000000200000000000020000000000002000000000000200000000000000001
1000000000000000000000000000000000000000000000000000000000000000000000000000000000000000000000000001
1000000000000000000000000000000000000000000000000000000000000000000000000000000000000000000000000001
1000000000000000000000000000000000000000000000000000000000000000000000000000000000000000000000000001
1000000000200000000000020000000000002000000000000200000000000020000000000002000000000000200000000001
1000000002320000000000232000000000023200000000002320000000000232000000000023200000000002320000000001
1000000000200000000000020000000000002000000000000200000000000020000000000002000000000000200000000001
1000000000000000000000000000000000000000000000000000000000000000000000000000000000000000000000000001
1000000000000000000000000000000000000000000000000000000000000000000000000000000000000000000000000001
1000000000000000000000000000000000000000000000000000000000000000000000000000000000000000000000000001
1000000000000000020000000000002000000000000200000000000020000000000002000000000000200000000000000001
1000000000000000232000000000023200000000002320000000000232000000000023200000000002320000000000000001
1000000000000000020000000000002000000000000200000000000020000000000002000000000000200000000000000001
1000000000000000000000000000000000000000000000000000000000000000000000000000000000000000000000000001
1000000000000000000000000000000000000000000000000000000000000000000000000000000000000000000000000001
1000000000000000000000000000000000000000000000000000000000000000000000000000000000000000000000000001
1000000000200000000000020000000000002000000000000200000000000020000000000002000000000000200000000001
1000000002320000000000232000000000023200000000002320000000000232000000000023200000000002320000000001
1000000000200000000000020000000000002000000000000200000000000020000000000002000000000000200000000001
1000000000000000000000000000000000000000000000000000000000000000000000000000000000000000000000000001
1000000000000000000000000000000000000000000000000000000000000000000000000000000000000000000000000001
1000000000000000000000000000000000000000000000000000000000000000000000000000000000000000000000000001
1111111111111111111111111111111111111111111111111111111111111111111111111111111111111111111111111111