1111111111111111111111111111111111111111111111111111111111111111111111111111111111111111111111111111
1000000000000000000000000000000000000000000000000000000000000000000000000000000000000000000000000001
1000000000000000000000000000000000000000000000000000000000000000000000000000000000000000000000000001
1000000000000011111000000000000000000000000000000000000000000000000000000111110000000000000000000001
1000000000000011111000000000000000000000000000000000000000000000000000000111110000000000000000000001
1000000000000011111000000000000000000000000000000000000000000000000000000111110000000000000000000001
1000000000000011111000000000000000000000000000000000000000000000000000000111110000000000000000000001
1000000000000011111000000000000000000000000000000000000000000000000000000111110000000000000000000001
1000001111111111111111111110000000000000000000000000000000000000011111111111111111111100000000000001
1000001111111111111111111110000000000000000000000000000000000000011111111111111111111100000000000001
1000001111111111111111111110000000000000000000000000000000000000011111111111111111111100000000000001
1000000000000011111000000000000000000000000000000000000000000000000000000111110000000000000000000001
1000000000000011111000000000000000000000000000000000000000000000000000000111110000000000000000000001
1000000000000011111000000000000000000000000000000000000000000000000000000111110000000000000000000001
1000000000000011111000000000000000000000000000000000000000000000000000000111110000000000000000000001
1000000000000011111000000000000000000000000000000000000000000000000000000111110000000000000000000001
1000000000000000000000000000000000000000000000000000000000000000000000000000000000000000000000000001
1000000000000000000000000000000000000000000000000000000000000000000000000000000000000000000000000001
1000000000000000000000000000000000000000000000000000000000000000000000000000000000000000000000000001
1000000000000000000000000000000000000000000000000000000000000000000000000000000000000000000000000001
1000000000000000000000000000000000000000000000000000000000000000000000000000000000000000000000000001
1000000000000000000000000000000000000000000000000000000000000000000000000000000000000000000000000001
1000000000000000000000000000000000000000000000000000000000000000000000000000000000000000000000000001
1000000000011000000000000000000000000000000000000000000000000000000000000000000000001100000000000001
1000000000001100000000000000000000000000000000000000000000000000000000000000000000011000000000000001
1000000000000110000000000000000000000000000000000000000000000000000000000000000000110000000000000001
1000000000000011000000000000000000000000000000000000000000000000000000000000000001100000000000000001
1000000000000001100000000000000000000000000000000000000000000000000000000000000011000000000000000001
1000000000000000110000000000000000000000000000000000000000000000000000000000000110000000000000000001
1000000000000000011000000000000000000000000000000000000000000000000000000000001100000000000000000001
1000000000000000001100000000000000000000000000000000000000000000000000000000011000000000000000000001
1000000000000000000110000000000000000000000000000000000000000000000000000000110000000000000000000001
1000000000000000000011000000000000000000000000000000000000000000000000000001100000000000000000000001
1000000000000000000001100000000000000000000000000000000000000000000000000011000000000000000000000001
1000000000000000000000111111111111111111111111111111111111111111111111111110000000000000000000000001
1000000000000000000000000000000000000000000000000000000000000000000000000000000000000000000000000001
1000000000000000000000000000000000000000000000000000000000000000000000000000000000000000000000000001
1000000000000000000000000000000000000000000000000000000000000000000000000000000000000000000000000001
1000000000000000000000000000000000000000000000000000000000000000000000000000000000000000000000000001
1111111111111111111111111111111111111111111111111111111111111111111111111111111111111111111111111111